11111111111111111111111111111
10000000000000000000000000001
10202020202020202020202020201
10202020202020202020202020201
10000000000020202000000000001
10000000000000000000000000001
10000000000000000000000000001
10002222200022222000222220001
10000000000000000000000000001
10022222200000000000222222001
10022222200220002200222222001
10022222200222222200222222001
10000000000220002200000000001
10000000000000000000000000001
10000000000000000000000000001
10202020202020202020202020201
10202020202020202020202020201
10202020202020202020202020201
10000000000000000000000000001
11111111111111111111111111111